üßæ Champs exclus (non s√©lectionn√©s)
Champ	Raison d‚Äôexclusion
Type	Trop g√©n√©rique, peu informatif pour la pr√©diction du retard.
Category Id	Redondant avec Category Name.
Customer City	Peu utile seule, tr√®s granulaire, cr√©e trop de cat√©gories.
Customer Country	Redondant avec Market ou Order Country.
Customer Email	Identifiant unique ‚Üí sans valeur pr√©dictive.
Customer Fname	Identifiant personnel, non pertinent.
Customer Id	Identifiant unique, non pr√©dictif.
Customer Lname	Identifiant personnel, non pertinent.
Customer Password	Donn√©e sensible, sans utilit√© analytique.
Customer State	Redondant avec Order State / Order Region.
Customer Street	Trop sp√©cifique, pas de valeur pr√©dictive.
Customer Zipcode	Trop granulaire, difficile √† exploiter.
Department Id	Redondant avec Department Name.
Department Name	Peut √™tre redondant avec Category Name / Market.
Latitude	Utilisable seulement avec g√©o-feature engineering, donc exclu pour simplification.
Longitude	M√™me raison que Latitude.
Order City	D√©j√† repr√©sent√© par Order Region et Market.
Order Country	Redondant avec Market.
Order Customer Id	Identifiant unique, non pr√©dictif.
order date (DateOrders)	Peut n√©cessiter un feature engineering (mois, jour, saison), donc exclu ici.
Order Item Cardprod Id	Identifiant produit, non pr√©dictif.
Order Item Discount	D√©j√† repr√©sent√© par Order Item Discount Rate.
Order Item Id	Identifiant unique, non pertinent.
Order Item Profit Ratio	Corr√©l√© √† Order Profit Per Order, risque de redondance.
Product Card Id	Identifiant produit, non utile seul.
Product Category Id	Redondant avec Category Name.
Product Description	Texte libre ‚Üí non exploit√© sans NLP.
Product Image	Lien web ‚Üí aucune valeur pr√©dictive.
Product Name	Trop sp√©cifique et cat√©goriel (trop de modalit√©s).
Product Price	Corr√©l√© avec Order Item Product Price / Sales.
Product Status	Indique disponibilit√©, peu corr√©l√© au d√©lai.
Shipping date (DateOrders)	Corr√©l√© √† la cible (risque de fuite de donn√©es).
Order State	Corr√©l√© √† Order Region.